#https://github.com/hemantjuyal/gaction-ridiculous-riddles/blob/master/functions/data/riddles.js
"question": "What word becomes shorter when you add two letters to it?",	"answer""Short"
"question": "What is it that you cannot hold even for ten minutes, even though it is lighter than a feather?",	"answer""Breath"
"question": "What becomes white when it is dirty?",	"answer""Blackboard"
"question": "What can you hold without ever touching it, or without using your hands?",	"answer""Your breath", "breath"
"question": "What word of five letters has only one left when two letters are removed?",	"answer""Stone"
"question": "If you drop a yellow hat in the Red Sea what will it become?",	"answer""Wet"
"question": "What goes up but never goes down?",	"answer""Age"
"question": "What building has the most stories?",	"answer""Library"
"question": "What do you call two witches who live together?",	"answer""Broommates"
"question": "You find me in December, but not in any other month. What am I?",	"answer""The letter D", "letter D"
"question": "Why shouldn’t you fall in love with a pastry chef?",	"answer""He will dessert you", "dessert you"
"question": "A bus driver goes the wrong way on a one way street. He passes the cops but they don’t stop him. Why?",	"answer""He was walking"
"question": "What is the easiest way to keep water from running?",	"answer""Don’t pay the bill", "don't pay the water bill"
"question": "How do you know carrots are good for your eyes?",	"answer""You never see rabbits wearing glasses", "rabbits don't wear glasses"
"question": "What has ten letters and starts with gas?",	"answer""Automobile"
"question": "A man goes out in heavy rain with nothing to protect him from it. His hair doesn’t get wet. How does he do that?",	"answer""He is bald", "bald"
"question": "What stones can you almost never find in an ocean?",	"answer""The Rolling Stones", "rolling stone"
"question": "What did the apple say to the banana?",	"answer""Nothing! Apples don't talk", "Apple don't talk", "Nothing"
"question": "Where do fish keep their money?",	"answer""Riverbank"
"question": "How many months have 28 days?",	"answer""All 12 months", "12 months"
"question": "How can a pants pocket be empty and still have something in it?",	"answer""It can have a hole in it", "hole", "pants have holes"
"question": "No matter how much rain comes down on it it won't get any wetter. What is it?",	"answer""Water"
"question": "How do you make the number one disappear by adding to it?",	"answer""Add the letter 'G' and it becomes Gone", "Gone"
"question": "Which word in the dictionary is spelled incorrectly?",	"answer""Incorrectly"
"question": "I have keys but no locks. I have a space but no room. You can enter, but can’t go outside. What am I?",	"answer""Keyboard"
"question": "What starts with E, ends with E, and has only 1 letter in it?",	"answer""Envelope"
"question": "If three cats kill three rats in three minutes, how long will it take hundred cats to kill hundred rats?",	"answer""3 minutes", "3"
